####################
#                  #
#                  #
######        ######
#                  #
#                  #
#     #####        #
#                  #
#                  #
#                  #
#                  #
####################